----------
-#--------
----------
----------
--#######-
--#######-
--#######-
--#######-
--#######-
----------
